                                
                        &       
               &         &      
                          &     
                 *  &           
              &      &          
      &&     &&                 
      &                         
         *                      
            &     & &           
   &   &&       *         &     
             *          &       
   &    &&   *                  
        &          &     &      
           &    &               
              *       ##     #  
  &            *     % #   # #  
   &     &   *        #     #   
      &              %     # #  
                     #    ###   
              *   ##% # # # #   
   *                  ##  #  #  
              # #    # ## %##   
                 #    #     #   
              ###   #   %       
                # #%    #       
                ###  # %        
              #%   ##           
              %  #              
                 %              
                                
                                
