                                
                                
                                
                                
                                
                                
                  *             
                   &            
                 &         & *  
          #  #  %#*        & &* 
   &*     #  ##                 
          #  ## #               
              #       *&  &   & 
 &              ##  &           
       &  #     #      &        
          #    #%# &         &  
       &      #%#   *   &       
  &                   &         
          &                 &   
                   &         &  
    &   %#          %         & 
           #  # # # ###      *  
           ## # ####  # #       
          #    #    %#  #       
     &    #  #      #%  #       
        &     #     #  #        
           # ##%##   %          
            ###    ## #         
    &*           #   % #        
   *            ##  ####        
                                
                                
